[apache_airflow_provider]
provider_info = datahub_provider:get_provider_info

[console_scripts]
datahub = datahub.entrypoints:main

[datahub.ingestion.sink.plugins]
console = datahub.ingestion.sink.console:ConsoleSink
datahub-kafka = datahub.ingestion.sink.datahub_kafka:DatahubKafkaSink
datahub-rest = datahub.ingestion.sink.datahub_rest:DatahubRestSink
file = datahub.ingestion.sink.file:FileSink

[datahub.ingestion.source.plugins]
athena = datahub.ingestion.source.athena:AthenaSource
bigquery = datahub.ingestion.source.bigquery:BigQuerySource
bigquery-usage = datahub.ingestion.source.bigquery_usage:BigQueryUsageSource
dbt = datahub.ingestion.source.dbt:DBTSource
druid = datahub.ingestion.source.druid:DruidSource
feast = datahub.ingestion.source.feast:FeastSource
file = datahub.ingestion.source.file:GenericFileSource
glue = datahub.ingestion.source.glue:GlueSource
hive = datahub.ingestion.source.hive:HiveSource
kafka = datahub.ingestion.source.kafka:KafkaSource
kafka-connect = datahub.ingestion.source.kafka_connect:KafkaConnectSource
ldap = datahub.ingestion.source.ldap:LDAPSource
looker = datahub.ingestion.source.looker:LookerDashboardSource
lookml = datahub.ingestion.source.lookml:LookMLSource
mongodb = datahub.ingestion.source.mongodb:MongoDBSource
mssql = datahub.ingestion.source.mssql:SQLServerSource
mysql = datahub.ingestion.source.mysql:MySQLSource
oracle = datahub.ingestion.source.oracle:OracleSource
postgres = datahub.ingestion.source.postgres:PostgresSource
redshift = datahub.ingestion.source.redshift:RedshiftSource
sagemaker = datahub.ingestion.source.sagemaker:SagemakerSource
snowflake = datahub.ingestion.source.snowflake:SnowflakeSource
snowflake-usage = datahub.ingestion.source.snowflake_usage:SnowflakeUsageSource
sqlalchemy = datahub.ingestion.source.sql_generic:SQLAlchemyGenericSource
superset = datahub.ingestion.source.superset:SupersetSource

