[console_scripts]
nb-get-help=cli:nb_get_help
nb-commit-html=cli:nb_commit_html
nb-commit-remote=cli:nb_commit_remote
nb-commit-local=cli:nb_commit_local
nb-commit-stage=cli:nb_commit_stage
nb-commit-settings=cli:nb_commit_settings
nb-git-clone-pnbp-blog=cli:nb_git_clone_pnbp_blog
nb-collect-code-blocked=cli:nb_collect_code_blocked
nb-collect-tasks-note=cli:nb_collect_tasks_note
nb-collect-public-graph=cli:nb_collect_public_graph
nb-collect-all-graphs=cli:nb_collect_all_graphs
nb-collect-subl-projs=cli:nb_collect_subl_projs
nb-collect-git-diff=cli:nb_collect_git_diff
nb-collect-all-stats=cli:nb_collect_all_stats
nb-collect-all-notes=cli:nb_collect_all_notes
nb-collect-all-urls=cli:nb_collect_all_urls
nb-collect-all-public=cli:nb_collect_all_public
nb-collect-terms=cli:nb_collect_terms
nb-collect-all-unlinked=cli:nb_collect_all_unlinked
nb-collect-all-empty=cli:nb_collect_all_empty
nb-collect-all-unheadered=cli:nb_collect_all_unheadered
nb-collect-all-moc=cli:nb_collect_all_moc
nb-collect-all-tags=cli:nb_collect_all_tags
nb-collect-nonexistant-links=cli:nb_collect_nonexistant_links
nb-collect-all=cli:nb_collect_all
nb-convert-datetime=cli:nb_convert_datetime
nb-git-commit-notebook=cli:nb_git_commit_notebook
nb-init-git-ignore=cli:nb_init_git_ignore
nbn-strip-links-spacing=cli:nbn_strip_links_spacing
nbn-expand-links-spacing=cli:nbn_expand_links_spacing
nb-prepend-leading-newline=cli:nb_prepend_leading_newline
nb-remove-leading-newline=cli:nb_remove_leading_newline
nb-remove-leading-and-trailing-newlines=cli:nb_remove_leading_and_trailing_newlines
nbn-link-unlinked-mentions=cli:nbn_link_unlinked_mentions
nb-collect-unlinked-mentions=cli:nb_collect_unlinked_mentions
nbn-remove-nonexistant-links=cli:nbn_remove_nonexistant_links
nb-delete-all-pnbp=cli:nb_delete_all_pnbp
nb-delete-all-empty=cli:nb_delete_all_empty
nb-touch-all-public=cli:nb_touch_all_public
nbn-extract-code-blocks=cli:nbn_extract_code_blocks
nbn-extract-all-code-blocks=cli:nbn_extract_all_code_blocks
nbn-create-link-graph=cli:nbn_create_link_graph
nb-create-tag-graph=cli:nb_create_tag_graph
nb-delete-all-graph-dash-name=cli:nb_delete_all_graph_dash_name
nbn-pprint=cli:nbn_pprint
nb-subl-init=cli:nb_subl_init
nb-task-settle=cli:nb_task_settle